[Info]
9	14	3	11	16	41
[Map]
1	1	1	2	3	4	3	5	3	6	3	4	1	1
1	1	1	7	1	1	1	7	1	1	1	7	1	1
3	8	3	9	1	1	1	10	3	11	3	12	1	1
1	1	1	13	1	1	1	7	1	1	1	1	1	1
1	1	1	10	3	14	3	15	1	1	16	17	18	1
1	19	19	7	19	1	1	1	16	17	20	21	22	1
19	19	23	10	23	12	3	4	24	4	3	25	26	1
19	23	23	7	23	23	19	7	26	19	19	19	26	1
19	23	23	27	3	4	3	28	29	17	17	17	20	1