[Info]
9	14
[Map]
0	0	0	2	1	20	1	2	1	2	1	20	0	0
0	0	0	1	0	0	0	1	0	0	0	1	0	0
0	2	1	20	0	0	0	20	1	2	1	2	0	0
0	0	0	0	0	0	0	1	0	0	0	0	0	0
0	0	0	20	1	2	1	2	0	0	0	0	0	0
0	0	0	1	0	0	0	0	0	0	0	0	0	0
0	0	0	20	0	1	1	20	1	20	1	2	0	0
0	0	0	1	0	0	0	1	0	0	0	0	0	0
0	0	0	2	1	20	1	2	0	0	0	0	0	0